NO     ./textures/mossy.xpm   
SO ./textures/wood.xpm
F  38,   26,  0   


WE      ./textures/eagle.xpm
EA   ./textures/colorstone.xpm


C 0, 230,240



        1111111111111111111111111
        1000000000000000000000001
        1011000001110000000000001
   1    1111111111100111111111111
   1              1001
   1    1111111111100111111111111
   1    1001000000000000000000001
111111111011000001110000000000001
100000000000000001110111111111111
11110111111111011100000000001
11110111111111011101010000001  11
11000000110101011100010000001  1
100000000000000011000000100011
100000000000000000000000100001
11000001110101011111011000N101
11110111 1110101 1011110100001
111111111 11111111111111111111
