NO     ./textures/bluestone.xpm   
SO ./textures/colorstone.xpm
F  38,   26,  0   


WE      ./textures/eagle.xpm
EA   ./textures/greystone.xpm


C 20, 134, 100



        1111111111111111111111111
        1000000000000000000000001
        1011000001110000000000001
   1    1111111111100111111111111
   1              1001
   1    1111111111100111111111111
   1    1001000000000000000000001
111111111011000001110000000000001
100000000000000001110111111111111
111100000000000111011100000000001
111100000000001110101000000111111
1100000000000000111E0010000001
100000000000000011000000100011
100000000000000000000000100001
110000011101010111110110000101
11110111 1110101 1011110100001
111111111 11111111111111111111
